1111111111111
1001000000001
1000011111001
1P00110000001
1111111111111
1111111111111
1001000000001
1000011111001
1P0011E000001
1111111111111
